File Name,LOC,LLOC,SLOC,Comments,Cyclomatic Complexity,Maintainability Index,h1,h2,h,N1,N2,N,Vocabulary,Volume,Difficulty,Effort,Bugs,Time
66.py,2,2,2,0,3,100.0,0,0,0,0,0,0,0,0,0,0,0.0,0.0
64.py,9,9,9,0,4,68.82557417717732,3,4,7,3,6,9,7,25.26619429851844,2.25,56.848937171666485,0.008422064766172813,3.158274287314805
34.py,2,2,2,0,1,100.0,0,0,0,0,0,0,0,0,0,0,0.0,0.0
120.py,2,3,2,0,1,100.0,0,0,0,0,0,0,0,0,0,0,0.0,0.0
46.py,13,10,10,0,4,62.35226939706738,5,14,19,12,24,36,19,152.92539048396907,4.285714285714286,655.3945306455817,0.050975130161323025,36.41080725808787
2.py,2,2,2,0,1,88.5574946685516,1,2,3,1,2,3,3,4.754887502163469,0.5,2.3774437510817346,0.0015849625007211565,0.1320802083934297
6.py,28,18,18,10,8,89.83228556589155,2,5,7,5,8,13,7,36.49561398674886,1.6,58.39298237879817,0.012165204662249619,3.2440545765998987
133.py,2,2,2,0,2,88.42299174457497,1,2,3,1,2,3,3,4.754887502163469,0.5,2.3774437510817346,0.0015849625007211565,0.1320802083934297
15.py,2,2,2,0,1,88.5574946685516,1,2,3,1,2,3,3,4.754887502163469,0.5,2.3774437510817346,0.0015849625007211565,0.1320802083934297
48.py,2,3,2,0,1,82.00171614982087,2,3,5,2,3,5,5,11.60964047443681,1.0,11.60964047443681,0.0038698801581456034,0.6449800263576005
81.py,17,4,17,0,2,100.0,0,0,0,0,0,0,0,0,0,0,0.0,0.0
20.py,18,11,10,2,3,93.43028432064203,3,9,12,6,12,18,12,64.52932501298082,2.0,129.05865002596164,0.02150977500432694,7.169925001442313
43.py,6,6,6,0,4,72.4649970147854,2,6,8,3,6,9,8,27.0,1.0,27.0,0.009,1.5
55.py,5,5,5,0,2,73.5864370401145,3,5,8,4,8,12,8,36.0,2.4,86.39999999999999,0.012,4.8
89.py,5,6,5,0,1,78.14958877590634,1,2,3,1,2,3,3,4.754887502163469,0.5,2.3774437510817346,0.0015849625007211565,0.1320802083934297
27.py,2,2,2,0,1,100.0,0,0,0,0,0,0,0,0,0,0,0.0,0.0
57.py,4,4,4,0,5,72.24850544806722,6,11,17,8,16,24,17,98.09910819000817,4.363636363636363,428.06883573821744,0.03269970273000272,23.781601985456525
96.py,6,6,6,0,4,70.36990987149105,4,8,12,5,10,15,12,53.77443751081735,2.5,134.43609377704337,0.017924812503605784,7.468671876502409
143.py,16,14,14,0,7,61.97746292794532,5,8,13,5,10,15,13,55.506595772116384,3.125,173.4581117878637,0.01850219859070546,9.636561765992427
129.py,22,20,21,0,2,56.41786678597934,7,16,23,10,20,30,23,135.7068586817104,4.375,593.717506732483,0.04523561956057014,32.98430592958239
32.py,28,16,14,0,8,85.60972866553715,10,19,29,14,25,39,29,189.46125880997533,6.578947368421052,1246.4556500656272,0.06315375293665844,69.24753611475707
88.py,6,6,6,0,2,71.81380425592978,4,6,10,4,7,11,10,36.541209043760986,2.3333333333333335,85.26282110210897,0.012180403014586996,4.736823394561609
127.py,10,10,10,0,3,66.717734318746,4,5,9,4,8,12,9,38.03910001730775,3.2,121.72512005538482,0.012679700005769252,6.762506669743601
83.py,2,2,2,0,4,79.71996924139252,5,9,14,7,13,20,14,76.14709844115208,3.611111111111111,274.97563325971583,0.025382366147050694,15.276424069984213
98.py,7,7,7,0,4,68.64803339719332,5,10,15,5,10,15,15,58.60335893412778,2.5,146.50839733531944,0.019534452978042596,8.139355407517748
8.py,7,7,7,0,2,73.28575273835813,2,3,5,2,4,6,5,13.931568569324174,1.3333333333333333,18.575424759098897,0.004643856189774725,1.0319680421721609
62.py,2,2,2,0,2,88.42299174457497,1,2,3,1,2,3,3,4.754887502163469,0.5,2.3774437510817346,0.0015849625007211565,0.1320802083934297
37.py,7,7,7,0,3,100.0,0,0,0,0,0,0,0,0,0,0,0.0,0.0
84.py,2,3,2,0,1,100.0,0,0,0,0,0,0,0,0,0,0,0.0,0.0
139.py,5,5,5,0,2,76.14705226402761,2,4,6,2,4,6,6,15.509775004326936,1.0,15.509775004326936,0.005169925001442312,0.861654166907052
110.py,12,12,12,0,7,62.115051559591045,5,10,15,7,14,21,15,82.0447025077789,3.5,287.15645877722613,0.02734823416925963,15.953136598734785
146.py,6,6,6,0,5,67.08322281646534,8,14,22,11,23,34,22,151.6206750336681,6.571428571428571,996.3644359355333,0.050540225011222704,55.35357977419629
75.py,7,7,7,0,6,65.2301117456102,9,15,24,12,24,36,24,165.05865002596164,7.2,1188.422280186924,0.05501955000865388,66.02346001038467
36.py,6,6,6,0,5,68.23764225249928,6,14,20,8,16,24,20,103.72627427729671,3.4285714285714284,355.63294037930297,0.0345754247590989,19.757385576627943
102.py,7,7,7,0,4,68.71327751879107,5,7,12,6,10,16,12,57.359400011538504,3.5714285714285716,204.85500004120897,0.01911980000384617,11.38083333562272
21.py,7,5,5,0,2,74.66308527157166,2,5,7,3,6,9,7,25.26619429851844,1.2,30.319433158222125,0.008422064766172813,1.6844129532345624
121.py,2,2,2,0,4,80.77781576413629,4,8,12,5,10,15,12,53.77443751081735,2.5,134.43609377704337,0.017924812503605784,7.468671876502409
149.py,2,2,2,0,1,100.0,0,0,0,0,0,0,0,0,0,0,0.0,0.0
38.py,24,14,12,4,8,85.89317755718729,4,18,22,14,28,42,22,187.29612798276648,3.111111111111111,582.6990648352735,0.06243204266092216,32.372170268626306
135.py,5,5,5,0,3,73.20852939104878,3,5,8,5,8,13,8,39.0,2.4,93.6,0.013,5.199999999999999
58.py,2,2,2,0,1,100.0,0,0,0,0,0,0,0,0,0,0,0.0,0.0
162.py,8,6,6,0,2,78.01508585192973,1,2,3,1,2,3,3,4.754887502163469,0.5,2.3774437510817346,0.0015849625007211565,0.1320802083934297
113.py,2,2,2,0,6,76.55398955591903,3,23,26,14,28,42,26,197.4184681619259,1.826086956521739,360.50328968699506,0.0658061560539753,20.027960538166393
86.py,7,7,7,0,2,100.0,0,0,0,0,0,0,0,0,0,0,0.0,0.0
160.py,14,14,14,0,7,59.16779767324202,6,16,22,10,20,30,22,133.78294855911892,3.75,501.68605709669595,0.044594316186372975,27.87144761648311
147.py,13,9,9,4,6,92.06283596466908,5,14,19,11,22,33,19,140.1816079436383,3.9285714285714284,550.713459778579,0.04672720264787944,30.595192209921056
42.py,2,2,2,0,2,88.42299174457497,1,2,3,1,2,3,3,4.754887502163469,0.5,2.3774437510817346,0.0015849625007211565,0.1320802083934297
157.py,5,5,5,0,2,72.47456280386446,3,8,11,5,10,15,11,51.89147427955947,1.875,97.296514274174,0.01729715809318649,5.405361904120777
33.py,2,2,2,0,1,100.0,0,0,0,0,0,0,0,0,0,0,0.0,0.0
59.py,14,12,12,0,9,59.94048908383084,7,17,24,12,23,35,24,160.4736875252405,4.735294117647059,759.8901085754036,0.05349122917508017,42.21611714307798
152.py,2,2,2,0,2,88.42299174457497,1,2,3,1,2,3,3,4.754887502163469,0.5,2.3774437510817346,0.0015849625007211565,0.1320802083934297
116.py,3,2,2,1,1,100.0,0,0,0,0,0,0,0,0,0,0,0.0,0.0
53.py,2,2,2,0,1,88.5574946685516,1,2,3,1,2,3,3,4.754887502163469,0.5,2.3774437510817346,0.0015849625007211565,0.1320802083934297
108.py,6,6,6,0,4,74.15078956223692,2,4,6,2,4,6,6,15.509775004326936,1.0,15.509775004326936,0.005169925001442312,0.861654166907052
45.py,2,2,2,0,1,84.96220422681199,2,4,6,2,4,6,6,15.509775004326936,1.0,15.509775004326936,0.005169925001442312,0.861654166907052
163.py,6,6,6,0,3,72.43195764141169,3,6,9,3,6,9,9,28.529325012980813,1.5,42.793987519471216,0.009509775004326938,2.377443751081734
67.py,4,4,4,0,1,78.7218789164598,1,4,5,2,4,6,5,13.931568569324174,0.5,6.965784284662087,0.004643856189774725,0.3869880158145604
30.py,2,2,2,0,3,88.28848882059837,1,2,3,1,2,3,3,4.754887502163469,0.5,2.3774437510817346,0.0015849625007211565,0.1320802083934297
87.py,7,7,7,0,4,76.28570514245513,1,2,3,1,2,3,3,4.754887502163469,0.5,2.3774437510817346,0.0015849625007211565,0.1320802083934297
65.py,9,6,5,4,1,100.0,3,4,7,4,8,12,7,33.68825906469125,3.0,101.06477719407376,0.011229419688230418,5.614709844115208
148.py,10,10,10,0,4,64.81166615748926,5,7,12,7,12,19,12,68.11428751370197,4.285714285714286,291.9183750587227,0.022704762504567322,16.217687503262372
137.py,9,9,9,0,4,68.82557417717732,3,4,7,3,6,9,7,25.26619429851844,2.25,56.848937171666485,0.008422064766172813,3.158274287314805
142.py,10,10,10,0,4,63.1611916248429,4,11,15,10,20,30,15,117.20671786825557,3.6363636363636362,426.2062467936566,0.03906890595608519,23.67812482186981
107.py,18,15,14,0,6,60.55293654344536,4,11,15,7,13,20,15,78.13781191217038,2.3636363636363638,184.68937361058454,0.026045937304056792,10.260520756143585
39.py,9,9,9,0,5,65.10946651498219,7,8,15,7,14,21,15,82.0447025077789,6.125,502.52380286014574,0.02734823416925963,27.917989047785873
119.py,10,10,10,0,6,64.93880260241076,4,6,10,6,12,18,10,59.794705707972525,4.0,239.1788228318901,0.019931568569324175,13.28771237954945
52.py,2,2,2,0,2,88.42299174457497,1,2,3,1,2,3,3,4.754887502163469,0.5,2.3774437510817346,0.0015849625007211565,0.1320802083934297
105.py,8,8,8,0,4,68.0860309991072,5,5,10,5,9,14,10,46.50699332842308,4.5,209.28146997790384,0.01550233110947436,11.62674833210577
22.py,2,2,2,0,3,100.0,0,0,0,0,0,0,0,0,0,0,0.0,0.0
123.py,12,11,11,0,3,62.085743723450754,5,15,20,10,20,30,20,129.65784284662087,3.3333333333333335,432.19280948873626,0.043219280948873624,24.010711638263125
54.py,2,2,2,0,4,83.07472846242624,2,5,7,3,6,9,7,25.26619429851844,1.2,30.319433158222125,0.008422064766172813,1.6844129532345624
56.py,10,10,10,0,4,69.1689588044931,2,3,5,3,4,7,5,16.253496664211536,1.3333333333333333,21.67132888561538,0.005417832221403845,1.2039627158675212
17.py,4,5,4,0,2,100.0,0,0,0,0,0,0,0,0,0,0,0.0,0.0
93.py,16,16,16,0,5,59.38200897456845,4,11,15,8,15,23,15,89.85848369899593,2.727272727272727,245.0685919063525,0.02995282789966531,13.614921772575139
29.py,2,2,2,0,3,100.0,0,0,0,0,0,0,0,0,0,0,0.0,0.0
90.py,9,9,9,0,5,67.1811139707765,4,7,11,4,8,12,11,41.51317942364757,2.2857142857142856,94.88726725405158,0.01383772647454919,5.27151484744731
114.py,14,8,7,3,3,100.0,1,2,3,1,2,3,3,4.754887502163469,0.5,2.3774437510817346,0.0015849625007211565,0.1320802083934297
115.py,9,9,9,0,4,68.82557417717732,3,4,7,3,6,9,7,25.26619429851844,2.25,56.848937171666485,0.008422064766172813,3.158274287314805
118.py,5,5,5,0,3,74.88675298233962,3,4,7,3,5,8,7,22.458839376460833,1.875,42.11032383086406,0.007486279792153611,2.3394624350480036
95.py,15,15,15,0,8,65.71232290248338,1,3,4,3,3,6,4,12.0,0.5,6.0,0.004,0.3333333333333333
50.py,5,3,2,0,2,94.59472743913393,3,8,11,4,8,12,11,41.51317942364757,1.5,62.26976913547136,0.01383772647454919,3.4594316186372978
82.py,2,2,2,0,1,88.5574946685516,1,2,3,1,2,3,3,4.754887502163469,0.5,2.3774437510817346,0.0015849625007211565,0.1320802083934297
106.py,9,9,9,0,3,66.77155463344673,4,7,11,5,10,15,11,51.89147427955947,2.857142857142857,148.26135508445563,0.01729715809318649,8.236741949136423
4.py,6,4,4,0,2,76.57525125534227,2,6,8,3,6,9,8,27.0,1.0,27.0,0.009,1.5
49.py,2,2,2,0,1,84.96220422681199,2,4,6,2,4,6,6,15.509775004326936,1.0,15.509775004326936,0.005169925001442312,0.861654166907052
103.py,9,10,9,0,3,64.18215855029119,5,9,14,8,15,23,14,87.56916320732489,4.166666666666667,364.87151336385375,0.029189721069108297,20.27063963132521
101.py,2,2,2,0,1,100.0,0,0,0,0,0,0,0,0,0,0,0.0,0.0
47.py,6,6,6,0,2,68.75002737935836,6,12,18,8,16,24,18,100.07820003461549,4.0,400.31280013846197,0.0333594000115385,22.23960000769233
63.py,7,7,7,0,3,68.02084750679403,4,8,12,7,14,21,12,75.28421251514429,3.5,263.494743803005,0.025094737505048096,14.638596877944723
14.py,2,3,2,0,2,84.58174335197131,1,2,3,1,2,3,3,4.754887502163469,0.5,2.3774437510817346,0.0015849625007211565,0.1320802083934297
35.py,2,2,2,0,1,100.0,0,0,0,0,0,0,0,0,0,0,0.0,0.0
5.py,9,9,9,0,3,70.44404409360986,2,4,6,2,4,6,6,15.509775004326936,1.0,15.509775004326936,0.005169925001442312,0.861654166907052
70.py,9,9,9,0,3,100.0,0,0,0,0,0,0,0,0,0,0,0.0,0.0
155.py,10,10,10,0,3,65.01417528931086,5,8,13,6,12,18,13,66.60791492653966,3.75,249.77968097452373,0.022202638308846556,13.876648943029096
41.py,2,2,2,0,1,83.27641167936048,3,5,8,3,6,9,8,27.0,1.8,48.6,0.009,2.7
91.py,6,6,6,0,3,72.80132549375759,1,6,7,3,6,9,7,25.26619429851844,0.5,12.63309714925922,0.008422064766172813,0.701838730514401
145.py,2,3,2,0,2,100.0,0,0,0,0,0,0,0,0,0,0,0.0,0.0
74.py,5,5,5,0,2,79.7423427057672,1,2,3,1,2,3,3,4.754887502163469,0.5,2.3774437510817346,0.0015849625007211565,0.1320802083934297
122.py,2,3,2,0,1,100.0,0,0,0,0,0,0,0,0,0,0,0.0,0.0
68.py,42,10,9,0,5,54.35460686312832,3,6,9,4,6,10,9,31.699250014423125,1.5,47.548875021634686,0.010566416671474375,2.6416041678685938
73.py,17,10,10,4,5,90.74512765440984,4,8,12,13,26,39,12,139.8135375281251,6.5,908.7879939328132,0.04660451250937503,50.488221885156285
19.py,4,5,4,0,1,82.51037454950637,1,1,2,1,1,2,2,2.0,0.5,1.0,0.0006666666666666666,0.05555555555555555
3.py,7,7,7,0,3,73.15124981438153,2,3,5,2,4,6,5,13.931568569324174,1.3333333333333333,18.575424759098897,0.004643856189774725,1.0319680421721609
23.py,2,2,2,0,1,100.0,0,0,0,0,0,0,0,0,0,0,0.0,0.0
78.py,11,11,11,0,6,64.0358640568961,2,8,10,6,12,18,10,59.794705707972525,1.5,89.69205856195879,0.019931568569324175,4.9828921423310435
16.py,2,2,2,0,1,100.0,0,0,0,0,0,0,0,0,0,0,0.0,0.0
97.py,2,2,2,0,1,84.8197741152723,2,3,5,3,4,7,5,16.253496664211536,1.3333333333333333,21.67132888561538,0.005417832221403845,1.2039627158675212
125.py,7,7,7,0,6,68.54412042798691,4,9,13,5,10,15,13,55.506595772116384,2.2222222222222223,123.34799060470309,0.01850219859070546,6.852666144705727
11.py,2,2,2,0,2,88.42299174457497,1,2,3,1,2,3,3,4.754887502163469,0.5,2.3774437510817346,0.0015849625007211565,0.1320802083934297
24.py,4,4,4,0,3,76.79891896611021,3,5,8,3,5,8,8,24.0,1.5,36.0,0.008,2.0
76.py,2,2,2,0,1,84.96220422681199,2,4,6,2,4,6,6,15.509775004326936,1.0,15.509775004326936,0.005169925001442312,0.861654166907052
80.py,7,7,7,0,6,65.86448753980045,5,15,20,10,21,31,20,133.97977094150824,3.5,468.9291982952788,0.04465992364716941,26.05162212751549
9.py,8,8,8,0,3,75.15517382051522,1,2,3,1,2,3,3,4.754887502163469,0.5,2.3774437510817346,0.0015849625007211565,0.1320802083934297
69.py,18,12,12,3,6,88.12828493435495,6,8,14,6,11,17,14,64.72503367497926,4.125,266.99076390928946,0.021575011224993085,14.832820217182748
25.py,15,13,13,0,5,60.86152706171268,6,9,15,9,18,27,15,105.48604608143,6.0,632.91627648858,0.03516201536047667,35.162015360476666
112.py,6,7,6,0,3,70.3613561036311,4,5,9,4,7,11,9,34.86917501586544,2.8,97.63369004442322,0.011623058338621813,5.424093891356845
13.py,4,4,4,0,2,78.58737599248319,2,3,5,2,4,6,5,13.931568569324174,1.3333333333333333,18.575424759098897,0.004643856189774725,1.0319680421721609
7.py,2,2,2,0,3,88.28848882059837,1,2,3,1,2,3,3,4.754887502163469,0.5,2.3774437510817346,0.0015849625007211565,0.1320802083934297
144.py,9,3,2,1,1,100.0,0,0,0,0,0,0,0,0,0,0,0.0,0.0
104.py,2,3,2,0,2,79.65883099752473,3,5,8,3,5,8,8,24.0,1.5,36.0,0.008,2.0
140.py,2,2,2,0,1,100.0,0,0,0,0,0,0,0,0,0,0,0.0,0.0
130.py,13,13,13,0,5,59.849306908361285,5,12,17,12,24,36,17,147.14866228501225,5.0,735.7433114250613,0.04904955409500408,40.874628412503405
0.py,6,6,6,0,4,72.29745471743507,3,6,9,3,6,9,9,28.529325012980813,1.5,42.793987519471216,0.009509775004326938,2.377443751081734
1.py,3,2,2,1,1,100.0,0,0,0,0,0,0,0,0,0,0,0.0,0.0
85.py,5,5,5,0,2,79.7423427057672,1,2,3,1,2,3,3,4.754887502163469,0.5,2.3774437510817346,0.0015849625007211565,0.1320802083934297
154.py,6,7,6,0,3,70.81873052670217,3,5,8,4,6,10,8,30.0,1.8,54.0,0.01,3.0
156.py,21,14,21,0,4,57.87328184194598,6,18,24,17,34,51,24,233.833087536779,5.666666666666667,1325.0541627084144,0.07794436251225967,73.61412015046747
28.py,2,2,2,0,1,100.0,0,0,0,0,0,0,0,0,0,0,0.0,0.0
131.py,7,7,7,0,3,68.3932010739936,5,8,13,6,12,18,13,66.60791492653966,3.75,249.77968097452373,0.022202638308846556,13.876648943029096
138.py,2,2,2,0,2,81.83377702795524,4,7,11,4,8,12,11,41.51317942364757,2.2857142857142856,94.88726725405158,0.01383772647454919,5.27151484744731
61.py,10,10,10,0,5,65.07330552638736,4,6,10,6,12,18,10,59.794705707972525,4.0,239.1788228318901,0.019931568569324175,13.28771237954945
99.py,2,2,2,0,1,100.0,0,0,0,0,0,0,0,0,0,0,0.0,0.0
77.py,2,2,2,0,1,81.41305188706629,3,7,10,5,10,15,10,49.82892142331044,2.142857142857143,106.77626019280808,0.016609640474436815,5.932014455156004
100.py,8,8,8,0,3,67.6911364274339,4,7,11,6,10,16,11,55.350905898196764,2.857142857142857,158.14544542341932,0.018450301966065587,8.785858079078851
161.py,8,9,8,0,6,68.03434822369007,3,5,8,4,6,10,8,30.0,1.8,54.0,0.01,3.0
136.py,9,9,9,0,8,63.42319625761208,5,13,18,10,20,30,18,125.09775004326937,3.8461538461538463,481.145192474113,0.04169925001442312,26.730288470784057
51.py,3,3,3,0,3,84.44724042799471,1,2,3,1,2,3,3,4.754887502163469,0.5,2.3774437510817346,0.0015849625007211565,0.1320802083934297
94.py,15,13,13,0,8,61.82551452496557,5,10,15,6,12,18,15,70.32403072095333,3.0,210.97209216286,0.02344134357365111,11.720671786825555
109.py,11,7,7,2,4,95.85487317634782,4,7,11,4,8,12,11,41.51317942364757,2.2857142857142856,94.88726725405158,0.01383772647454919,5.27151484744731
72.py,5,5,5,0,3,73.28322106537321,4,7,11,4,7,11,11,38.053747805010275,2.0,76.10749561002055,0.012684582601670092,4.228194200556697
132.py,18,12,12,6,6,93.83134929591263,2,6,8,4,8,12,8,36.0,1.3333333333333333,48.0,0.012,2.6666666666666665
124.py,22,17,16,0,12,79.97563243525245,8,29,37,16,31,47,37,244.84430818456065,4.275862068965517,1046.9204901684661,0.08161476939485354,58.162249453803675
40.py,7,7,7,0,5,68.88342231657579,2,9,11,5,10,15,11,51.89147427955947,1.1111111111111112,57.65719364395497,0.01729715809318649,3.203177424664165
79.py,6,6,6,0,2,70.19287782410387,4,7,11,6,12,18,11,62.26976913547136,3.4285714285714284,213.49635132161606,0.020756589711823786,11.860908406756447
12.py,4,4,4,0,2,84.48986316429594,1,1,2,1,1,2,2,2.0,0.5,1.0,0.0006666666666666666,0.05555555555555555
159.py,6,6,6,0,2,72.73400286273859,3,5,8,3,6,9,8,27.0,1.8,48.6,0.009,2.7
117.py,3,3,3,0,3,84.44724042799471,1,2,3,1,2,3,3,4.754887502163469,0.5,2.3774437510817346,0.0015849625007211565,0.1320802083934297
111.py,22,16,16,3,7,84.43860437569947,4,6,10,4,8,12,10,39.863137138648355,2.6666666666666665,106.3016990363956,0.013287712379549451,5.905649946466422
18.py,6,6,6,0,3,72.599499938762,2,6,8,3,6,9,8,27.0,1.0,27.0,0.009,1.5
158.py,2,3,2,0,1,100.0,0,0,0,0,0,0,0,0,0,0,0.0,0.0
126.py,2,2,2,0,3,80.72929484183068,5,9,14,5,10,15,14,57.110323830864054,2.7777777777777777,158.6397884190668,0.019036774610288017,8.813321578837044
92.py,5,5,5,0,4,70.9325119231462,3,9,12,7,15,22,12,78.86917501586544,2.5,197.1729375396636,0.026289725005288478,10.954052085536865
153.py,7,7,7,0,6,70.73561630531078,2,6,8,3,6,9,8,27.0,1.0,27.0,0.009,1.5
31.py,7,7,7,0,4,68.90953500996966,5,7,12,5,10,15,12,53.77443751081735,3.5714285714285716,192.0515625386334,0.017924812503605784,10.6695312521463
60.py,2,2,2,0,1,83.27641167936048,3,5,8,3,6,9,8,27.0,1.8,48.6,0.009,2.7
44.py,12,4,2,0,1,52.84245160456168,1,2,3,1,2,3,3,4.754887502163469,0.5,2.3774437510817346,0.0015849625007211565,0.1320802083934297
151.py,6,6,6,0,4,69.63245789928568,6,8,14,6,12,18,14,68.53238859703687,4.5,308.3957486866659,0.022844129532345624,17.133097149259218
128.py,9,9,9,0,3,68.2703146982696,4,5,9,4,6,10,9,31.699250014423125,2.4,76.07820003461549,0.010566416671474375,4.22656666858975
26.py,2,2,2,0,1,100.0,0,0,0,0,0,0,0,0,0,0,0.0,0.0
134.py,5,5,5,0,3,73.69639031151141,4,6,10,4,6,10,10,33.219280948873624,2.0,66.43856189774725,0.01107309364962454,3.691031216541514
141.py,8,8,8,0,4,70.95661815356992,2,4,6,3,4,7,6,18.094737505048094,1.0,18.094737505048094,0.006031579168349364,1.0052631947248942
10.py,9,9,7,2,3,92.00629535154923,4,9,13,7,12,19,13,70.30835464468075,2.6666666666666665,187.48894571914866,0.02343611821489358,10.416052539952704
150.py,14,12,12,0,6,65.76383659076718,3,5,8,3,6,9,8,27.0,1.8,48.6,0.009,2.7
71.py,6,6,6,0,4,67.51262422040143,5,13,18,11,22,33,18,137.6075250475963,4.230769230769231,582.1856828936767,0.04586917501586544,32.343649049648704
